30 11
##########.........V..........
##########...######.#####..###
............H##...#.#....S.##G
##########.####.#V#.#......##.
H...............#.#######..##.
#################..#H......##.
.H..............#.#####...###.
.######.######..#.#....H....#.
.#.............H#.#####.#####.
.###########.####.##......H##.
P#...H............##..........